ACAD9, CPT1A, HMGCL, HMGCS2, SLC25A20, SLC52A2, Acyl-CoA dehydrogenase, short-chain, deficiency of, Brown-Vialetto-Van Laere Syndrome, Medium-chain Acyl-CoA dehydrogenase deficiency (ACADMD), Multiple acyl-CoA dehydrogenase deficiency, Rhabdomyolysis and metabolic muscle disorders_1.34	Rhabdomyolysis and metabolic muscle disorders	66
Adult solid tumours cancer susceptibility_2.2	Adult solid tumours cancer susceptibility	245
ASXL3, Bohring-Opitz syndrome, ASXL1, CD96, KLHL7, ASXL1, ASXL3, CD96	Bohring-Opitz syndrome	
ASXL3, SMC3, SMC1A, RAD21, Bohring-Opitz syndrome, KLHL7, HDAC8, CD96, NIPBL	Bohring-Opitz syndrome	
Ataxia and cerebellar anomalies - narrow panel_2.23	Ataxia and cerebellar anomalies	477
Ataxia and cerebellar anomalies - narrow panel_2.23, Ataxia and cerebellar anomalies - narrow panel_2.23, Niemann-Pick	Ataxia and cerebellar anomalies	477
ATP6V0A2, RAB3GAP2, PTEN, DYNC1H1, KIF5C, TUBB, COL3A1, Malformations of cortical development_2.2, RTTN, OFD1, SNAP29, TBC1D20, Malformations of cortical development_2.2, RAB18, KIF1B, GRIN2B, EOMES, DDX3X, TMEM216	Malformations of cortical development	96
Atrial septal defect	Atrial septal defect	
BAF (mSWI/SNF) complex	Coffin-Siris syndrome	
BAF (mSWI/SNF) complex, Coffin-Siris syndrome	Coffin-Siris syndrome	
Basal cell nevus syndrome	Basal cell nevus syndrome	
BLM, ACAN, SHOX, Growth failure in early childhood_1.4, ANKRD11	Growth failure in early childhood	
Branchiootorenal syndrome	Branchiootorenal syndrome	
Breast And Ovarian Cancer_ICE	Breast and ovarian cancer	
Breast Cancer_ICE	Breast cancer	
CACNA1A, Ataxia and cerebellar anomalies - narrow panel_2.23	Ataxia and cerebellar anomalies	477
CAKUT, Cystic kidney disease_2.2	Cystic kidney disease	283
CAKUT, Rare multisystem ciliopathy Super panel_4.21	Rare multisystem ciliopathy	728
CDKN1C, DIS3L2, DHCR24, CUL4B, CHD8, BRWD3, AKT1, White matter disorders and cerebral calcification - narrow panel_1.12, Malformations of cortical development_2.2, GLI3, Overgrowth, KIAA0196, Oral-facial-digital syndrome 1, PTCH1, UPF3B, TSC2, TSC1, SYN1, SETD2, RNF135, GRIA3, PTEN, GPSM2, PIGA, NFIX, MPDZ, MED12, L1CAM, KPTN, KIF7, HUWE1, RAB39B	White matter disorders and cerebral calcification	476
Charge syndrome	CHARGE syndrome	
Clefting_2.2	Clefting	81
Coffin-Siris syndrome	Coffin-Siris syndrome	
Coffin-Siris syndrome, SOX11, PHF6, SMARCA2	Coffin-Siris syndrome	
Congenital disorders of glycosylation_2.4	Congenital disorders of glycosylation	25
Congenital Erythromelalgia / Small fibre neuropathy	Erythromelalgia	
Congenital Erythromelalgia / Small fibre neuropathy, NAGLU, Pain - excess	Erythromelalgia	
Congenital Erythromelalgia / Small fibre neuropathy, Pain - insensitivity	Erythromelalgia	
Cornelia de Lange, Growth failure in early childhood_1.4, DDG2P_2.2	Developmental disorder	
CTSA, NOTCH3, White matter disorders and cerebral calcification - narrow panel_1.12, HTRA1	White matter disorders and cerebral calcification	476
Cylindromatosis, familial	Cylindromatosis	
Cystic kidney disease_2.2	Cystic kidney disease	283
Cystic kidney disease_2.2, CAKUT	Cystic kidney disease	283
DDG2P_2.2	Developmental disorder	
DDG2P_2.2, DDG2P_2.2, SHOX	Developmental disorder	
DDG2P_2.2, SHOX, FGFR3	Developmental disorder	
DDG2P_2.2, Three M syndrome, CDKN1C	Developmental disorder	
DHCR7, DDG2P_2.2	Developmental disorder	
Distal myopathies_1.18	Distal myopathies	235
DLX5, WNT10B, Limb disorders_2.2	Limb disorders	384
Episodic Ataxia	Episodic ataxia	
Fahr disease	Fahr disease	
FBN1, Overgrowth	Overgrowth	
FBN1, Weill-Marchesani syndrome 3, ADAMTS17, Weill-Marchesani syndrome 1	Weill-Marchesani syndrome	
FGFR3, TWIST1, FGFR1, FGFR2, FLNA, Rubinstein-Taybi syndrome, GLI3, KBG syndrome	Rubinstein-Taybi syndrome	
Focal segmental glomerulosclerosis	Focal segmental glomerulosclerosis	
Focal segmental glomerulosclerosis, Wilms tumor, Wilms tumor	Focal segmental glomerulosclerosis	
FXN, Ataxia and cerebellar anomalies - narrow panel_2.23	Ataxia and cerebellar anomalies	477
GDF1, ZIC3, TBX5, NR2F2, Notch2, NODAL, NKX2-5, JAG1, GATA4, FLNA, ELN, CFC1, ACVR2B, MYH6, CFAP53, Nonsyndromic Congenital Heart Disease Panel	Familial non syndromic congenital heart disease	212
GDF2, Hereditary Haemorrhagic Telangiectasia_2.2	Hereditary haemorrhagic telangiectasia	123
GLI3, Malformations of cortical development_2.2	Malformations of cortical development	96
Glomerular disease/Nephrotic syndrome	Glomerular disease/Nephrotic syndrome	
Growth failure in early childhood_1.4	Growth failure in early childhood	
Hereditary ataxia adult v2 110221	Hereditary ataxia with onset in adulthood	466
Hereditary ataxia childhood v2 110221	Hereditary ataxia and cerebellar anomalies - childhood onset	488
Hereditary Haemorrhagic Telangiectasia_2.2, GDF2	Hereditary haemorrhagic telangiectasia	123
Hyperekplexia	Hyperekplexia	
Hypertension	Hypertension	
Hypomyelination	Hypomyelination	
Kabuki Syndrome	Kabuki Syndrome	173
Kabuki Syndrome, Coffin-Siris syndrome, Kleefstra syndrome	Kabuki Syndrome	
KBG syndrome, Rubinstein-Taybi syndrome	KBG syndrome	
Leukoencephalopathy with cortical cysts, Stroke, White matter disorders and cerebral calcification - narrow panel_1.12	White matter disorders and cerebral calcification	476
Limb disorders_2.2	Limb disorders	384
Limb disorders_2.2, Holt-Oram syndrome	Limb disorders	384
Malformations of cortical development_2.2	Malformations of cortical development	96
Malformations of cortical development_2.2, Malformations of cortical development_2.2	Malformations of cortical development	96
Marfan syndrome	Marfan syndrome	
Mental retardation, XL 15	Mental retardation	
MGP, GGCX, VKORC1, Chondrodysplasia Punctata	Chondrodysplasia Punctata	
Movement disorders adult v2 110221	Movement disorders	
Movement disorders childhood v2 110221	Movement disorders	
Mowat-Wilson syndrome	Mowat-Wilson syndrome	
Multiple Epiphyseal Dysplasia	Multiple Epiphyseal Dysplasia	
Niemann-Pick	Niemann-Pick	
Nonsyndromic Congenital Heart Disease Panel, ABL1, Notch2, TRAF7, TAB2	Nonsyndromic congenital heart disease	
NSD1, PTEN, Overgrowth, NFIX, DNMT3A, RNF135, PDGFRB, MTOR, ZBTB20, PTCH1, DIS3L2, CHD8, GPC3, CDKN1C, PIK3CA, PPP2R5D, ABCC9, PPP2R5C, PTEN, HERC1, BRWD3, SETD2, SUZ12, PPP2R5B	Overgrowth	
Oculodentodigital syndrome	Oculodentodigital syndrome	
Osteosclerosis	Osteosclerosis	
Osteosclerosis, ALPL	Osteosclerosis	
Overgrowth	Overgrowth	
Overgrowth, ZBTB20, Basal cell nevus syndrome, NFIX, PTEN, DIS3L2	Overgrowth	
Pain - excess	Hereditary neuropathy	85
Pain - extended insensitivity, HPRT1, Pain - insensitivity	Hereditary neuropathy	85
Pain - insensitivity	Hereditary neuropathy	85
PHEX, TWIST1, RECQL4, FGFR3, CTSK, ALPL, RUNX2, Clefting_2.2, Bohring-Opitz syndrome	Clefting	81
Pituitary adenoma	Pituitary adenoma	
POLR1C, POLR3A, ADCY5, POLR3B, PDE10A, NKX2-1, Ataxia and cerebellar anomalies - narrow panel_2.23, PRNP	Ataxia and cerebellar anomalies	477
POLR1C, POLR3A, POLR3B, Ataxia and cerebellar anomalies - narrow panel_2.23	Ataxia and cerebellar anomalies	477
POLR3B, POLR3A, Ataxia and cerebellar anomalies - narrow panel_2.23, POLR1C	Ataxia and cerebellar anomalies	477
POLR3B, POLR3A, POLR1C, Ataxia and cerebellar anomalies - narrow panel_2.23	Ataxia and cerebellar anomalies	477
Pontocerebellar hypoplasia	Pontocerebellar hypoplasia	
Pontocerebellar hypoplasia, Ataxia and cerebellar anomalies - narrow panel_2.23, Malformations of cortical development_2.2	Ataxia and cerebellar anomalies	477
Pontocerebellar hypoplasia, PLA2G6	Pontocerebellar hypoplasia	
Pulmonary Fibrosis	Pulmonary Fibrosis	
Rare multisystem ciliopathy Super panel_4.21	Rare multisystem ciliopathy	728
Rare multisystem ciliopathy Super panel_4.21, PKHD1	Rare multisystem ciliopathy	729
Rare multisystem ciliopathy Super panel_4.21, WFS1	Rare multisystem ciliopathy	730
RBPJ, Limb disorders_2.2, Limb disorders_2.2, DLL4, EOGT, Adams Oliver syndrome	Limb disorders	384
Renal Complement	Renal Complement	
Rett like syndrome	Rett like syndrome	
RFC1, Ataxia and cerebellar anomalies - narrow panel_2.23	Ataxia and cerebellar anomalies	477
Rhabdomyolysis and metabolic muscle disorders_1.34	Rhabdomyolysis and metabolic muscle disorders	66
Rubinstein-Taybi syndrome	Rubinstein-Taybi syndrome	
SHOX, Rubinstein-Taybi syndrome	Rubinstein-Taybi syndrome	
Stargardt	Stargardt	
Stroke	ischemic stroke	
Stroke, ENPP1	ischemic stroke	
Stroke, SLC2A1, POLG, ATP1A3, OTC	ischemic stroke	
Stroke, White matter disorders and cerebral calcification - narrow panel_1.12	White matter disorders and cerebral calcification	476
Three M syndrome	Three M syndrome	
TP63, TBX3, Limb disorders_2.2	Limb disorders	384
TRPV1, Pain - excess	Hereditary neuropathy	85
Usher Syndrome	Usher syndrome	
Waardenburg syndrome	Waardenburg syndrome	
White matter disorders and cerebral calcification - narrow panel_1.12	White matter disorders and cerebral calcification	476
White matter disorders and cerebral calcification - narrow panel_1.12, White matter disorders and cerebral calcification - narrow panel_1.12	White matter disorders and cerebral calcification	476